h*~*****~**~~~~~~~~
~~~~~*~~*~~~~~*~~~~
*~*~*~~~~***~~*~~*~
~~~~~*****~*~~~~~~~
~*~~~~~~~***~~*~~**
~~~*~*~~***~~~~~*~*
~~~*~**~~~~~~*~~~~~
~~~~~*~~~~~~*~~~~~~
~~~~~*~*~*~~~~~**~~
~*~~*~~~***~~**~*~~
~~~*~~~~~*~~/bin/su