h~~~~~*~~**~~~*~~*~
*~~~~~~~*~**~*~~~*~
*~~~~~~*~*~~~~~**~*
~~~*~~~~~~~*~~~~~~*
~~~~~~**~***~*~*~~~
*~*~~*~~~~*~~~~~~~*
~***~~*~~~*~~*~*~**
~**~*~*****~~~*~~~~
~**~~~~~~**~~~~~~~~
~*~~~~*~~~~~~~~~~~~
**~~~~*~*~~~/bin/su